-1,-1,-1,-1,-1,-1,-1,-1,-1,-1,-1,-1,-1
-1,-1,-1,-1,-1,-1,-1,-1,-1,-1,-1,-1,-1
-1,-1,-1, A, 2, 2,10, 2, B,-1,-1,-1,-1
-1,-1,-1,-1,-1,-1, 3,-1, 3,-1,-1,-1,-1
-1,-1,-1,-1,-1,-1, 3,-1, 3,-1,-1,-1,-1
-1,-1,-1,-1,-1,-1, 3,-1, 3,-1,-1,-1,-1
-1,-1,-1,-1,-1,-1, 3,-1, 3,-1,-1,-1,-1
-1,-1,-1,-1,-1,-1, 5, 2, C,-1,-1,-1,-1
-1,-1,-1,-1,-1,-1,-1,-1,-1,-1,-1,-1,-1
-1,-1,-1,-1,-1,-1,-1,-1,-1,-1,-1,-1,-1